1,1,3,1,1,1,1,1,1,1,1,3,1,3,3,1,1,1,1,3,1,3,17,3,1,3,1,1,3,1
2,1,1,1,1,1,3,1,1,2,1,3,2,4,4,1,1,1,2,4,2,4,17,4,2,4,1,2,4,1
1,2,2,2,1,3,1,1,1,3,2,4,1,3,1,1,1,1,3,1,1,2,17,2,4,1,1,1,1,3
1,1,1,1,1,3,2,1,3,4,2,2,2,4,1,1,1,1,3,1,1,3,17,3,1,3,1,2,2,4
1,1,1,1,2,1,1,2,4,4,1,1,1,1,3,1,2,2,4,1,2,4,17,4,2,4,1,2,1,3
1,1,1,4,1,3,1,3,1,3,1,1,2,2,4,2,1,3,2,2,2,1,17,1,3,1,3,1,2,4
1,8,9,9,9,9,9,9,9,9,9,9,9,9,9,9,9,9,9,9,9,9,17,9,9,9,9,9,9,9
1,24,25,25,25,25,25,25,25,25,25,25,25,25,25,25,25,25,25,25,25,25,17,25,25,25,25,25,25,25
1,1,3,1,3,3,4,1,3,2,4,4,4,4,4,2,4,4,2,2,4,1,17,2,4,1,3,1,1,3
2,1,3,1,3,4,1,3,1,3,1,3,1,3,1,1,3,1,3,3,1,3,17,1,3,2,4,2,2,4
1,3,3,1,3,1,2,4,2,4,2,4,2,4,2,2,4,2,4,4,2,4,17,2,4,1,3,3,1,3
2,4,4,2,4,2,2,4,1,2,4,1,3,3,2,4,1,3,3,4,1,2,17,1,3,1,3,4,2,4
2,4,1,3,1,1,2,4,1,3,3,2,4,4,1,3,2,4,3,2,2,4,17,2,4,2,4,1,2,4
1,3,3,1,2,2,1,3,1,3,1,1,1,3,2,1,1,3,1,1,3,2,17,1,3,1,3,1,1,3
2,4,4,2,4,1,3,4,2,4,2,2,2,4,1,3,2,4,2,2,4,1,17,2,4,2,4,2,2,4

