1,1,3,1,1,1,1,1,1,1,1,1,1,1,1,3,1,3,3,1,3,3,3,3,1,3,1,1,1,1,1,1,1,1,3,1,1,1,1,3,1,3,3,1,3,3,1,1,1,1,1,1,1,1,1,1,3,3,1,1
1,1,3,2,2,2,2,2,2,1,2,1,2,2,2,4,1,3,4,1,1,1,1,1,1,1,1,1,3,1,1,3,2,2,4,1,2,1,1,3,2,4,4,2,4,4,1,2,2,2,1,1,2,2,2,1,1,1,2,1
2,1,1,2,4,4,4,4,4,2,2,2,2,4,2,4,1,1,1,2,2,1,1,1,3,2,2,2,1,1,1,1,1,1,1,2,1,2,2,4,2,1,3,3,2,4,2,2,1,3,3,1,2,2,4,2,2,1,1,1
2,2,1,3,4,3,3,4,4,2,4,2,4,3,3,3,1,1,1,1,3,2,1,1,1,1,1,1,1,1,1,1,2,2,1,1,2,4,1,1,3,1,1,1,1,3,2,2,2,4,1,2,2,4,3,3,4,2,2,1
2,1,1,3,3,4,4,2,4,2,4,2,4,3,1,1,1,1,1,1,1,1,1,1,3,3,3,2,2,2,2,2,2,4,2,2,2,4,2,2,4,2,2,2,2,4,1,2,2,4,2,2,2,4,4,4,3,1,3,2
0,0,0,0,0,0,0,0,0,0,0,0,0,1,2,2,2,1,2,2,2,2,2,2,4,4,3,1,4,4,4,4,4,4,4,4,4,4,4,4,4,4,4,4,4,4,1,2,1,3,1,2,2,4,4,4,4,2,4,1
0,0,5,5,5,5,5,5,5,5,5,5,0,2,2,4,4,2,2,4,1,2,4,4,2,4,3,1,1,1,1,1,1,1,1,1,1,4,1,1,1,1,1,1,1,4,1,2,1,1,2,2,4,3,3,4,4,1,3,2
0,0,5,5,5,5,5,5,5,5,5,5,0,1,1,1,1,2,4,1,1,2,2,2,4,2,4,1,3,3,1,1,1,1,3,1,3,4,3,1,3,1,1,3,1,4,1,3,1,1,1,2,4,4,4,3,1,1,3,1
0,0,5,5,5,5,5,5,5,5,5,5,0,1,1,2,1,1,1,1,1,2,4,1,2,1,3,2,4,4,1,1,1,2,4,2,4,4,4,2,4,1,2,4,1,4,1,1,2,1,2,2,2,2,4,1,3,2,4,2
0,0,5,5,5,5,5,5,5,5,5,5,0,1,1,1,1,2,2,1,2,2,4,1,3,2,4,1,3,1,1,1,1,3,1,1,2,4,2,4,1,1,1,1,3,4,1,2,2,2,1,1,2,4,1,3,1,3,3,2
0,0,5,5,5,5,5,5,5,5,5,5,0,1,1,1,1,1,1,1,3,2,1,3,4,2,2,2,4,1,1,1,1,3,1,1,3,4,3,1,3,1,2,2,4,4,1,2,2,2,2,2,2,4,1,1,2,4,4,3
0,0,5,5,5,5,5,5,5,5,5,5,0,1,1,1,1,1,1,2,1,1,2,4,4,1,1,1,1,3,1,2,2,4,1,2,4,4,4,2,4,1,2,1,3,4,1,2,1,2,4,1,3,1,3,1,1,3,3,4
0,0,0,0,0,0,5,5,5,0,0,0,0,1,1,1,1,1,4,1,3,1,3,1,3,1,1,2,2,4,2,1,3,2,2,2,1,4,1,3,1,3,1,2,4,4,2,1,2,2,4,2,4,1,3,2,2,1,3,3
0,0,5,5,5,5,5,5,5,5,5,5,1,1,1,1,8,9,9,9,9,9,9,9,9,9,9,9,9,9,9,9,9,9,9,9,9,9,9,9,9,9,9,9,9,1,2,2,1,3,4,2,4,2,4,1,1,2,4,4
0,0,5,5,5,5,5,5,5,5,5,5,1,1,1,1,24,25,25,25,25,25,25,25,25,25,25,25,25,25,25,25,25,25,25,25,25,25,25,25,25,25,25,25,25,1,1,3,2,4,4,2,4,4,1,1,2,1,1,3
0,0,5,5,5,5,5,5,5,5,5,5,0,1,1,1,1,3,1,3,3,4,1,3,2,4,4,4,4,4,2,4,4,2,2,4,1,4,2,4,1,3,1,1,3,4,1,3,1,2,1,1,3,4,2,1,1,3,1,3
0,0,5,5,5,5,5,5,5,5,5,5,0,1,1,2,1,3,1,3,4,1,3,1,3,1,3,1,3,1,1,3,1,3,3,1,3,4,1,3,2,4,2,2,4,4,1,1,2,1,2,1,1,3,1,2,1,1,1,3
0,0,5,5,5,5,5,5,5,5,5,5,0,1,1,1,3,3,1,3,1,2,4,2,4,2,4,2,4,2,2,4,2,4,4,2,4,4,2,4,1,3,3,1,4,4,1,1,1,2,2,1,3,3,2,2,1,1,3,3
0,0,5,5,5,5,5,5,5,5,5,5,0,1,1,2,4,4,2,4,2,2,4,1,2,4,1,3,3,2,4,1,3,3,4,1,2,4,1,3,1,3,4,2,4,4,1,2,1,2,4,2,4,3,2,2,1,1,1,1
0,0,5,5,5,5,5,5,5,5,5,5,0,1,1,2,4,1,3,1,1,2,4,1,3,3,2,4,4,1,3,2,4,3,2,2,4,4,2,4,2,4,1,2,4,4,1,1,2,1,3,2,4,3,1,1,2,2,1,1
0,0,5,5,5,5,5,5,5,5,5,5,0,1,1,1,3,1,3,3,2,1,3,1,3,1,1,1,3,2,1,1,3,1,1,3,2,4,1,3,1,3,1,1,3,4,1,2,2,2,4,1,3,4,2,1,2,2,1,1
0,0,5,5,5,5,5,5,5,5,5,5,0,1,1,1,3,1,3,4,1,1,1,1,1,3,1,1,3,1,3,2,4,2,2,4,1,4,2,4,2,4,1,1,3,4,1,1,1,1,3,2,1,3,2,2,4,2,1,1
0,0,5,5,5,5,5,5,5,5,5,5,0,1,1,1,3,1,1,1,1,1,1,1,3,1,1,1,3,3,1,1,1,1,3,1,1,3,1,1,1,1,2,1,1,3,1,1,2,2,4,2,1,3,2,1,3,3,2,2
0,0,5,5,5,5,5,5,5,5,5,5,0,1,3,2,1,2,1,1,1,1,1,1,1,1,1,1,1,3,2,2,1,1,1,2,2,1,2,2,1,1,1,3,1,3,3,2,2,1,3,1,3,1,3,2,4,3,2,1
0,0,0,0,0,0,0,0,0,0,0,0,0,1,1,1,2,1,1,1,2,2,1,1,1,2,2,2,1,1,1,1,2,2,2,2,4,1,1,1,2,2,2,4,3,3,3,2,2,1,3,1,3,1,3,2,4,3,1,2
2,1,3,4,3,3,2,4,3,3,4,3,1,1,2,2,2,2,2,2,2,4,2,2,2,4,4,4,1,2,2,2,2,4,2,4,1,2,2,2,4,4,4,4,4,4,4,2,1,2,4,1,3,3,3,2,4,4,1,1
1,3,3,3,3,4,2,4,4,3,3,3,2,2,2,4,1,2,2,4,4,4,2,4,4,2,4,4,2,2,4,2,2,2,4,1,2,2,2,4,4,4,4,4,4,1,2,4,2,1,3,1,3,4,1,2,4,1,3,1
1,3,4,3,1,1,3,3,3,3,3,3,3,3,3,4,3,3,2,4,3,1,3,2,4,2,4,2,4,2,4,1,3,2,4,3,2,2,2,2,2,4,4,4,2,2,2,2,2,1,3,1,1,3,3,2,4,2,4,1
1,1,1,1,1,3,3,4,4,3,3,1,3,4,4,4,4,4,4,2,4,2,4,1,1,1,3,2,4,2,2,2,4,2,2,4,1,3,2,2,4,2,1,3,3,3,1,1,2,2,4,1,3,4,1,3,2,4,1,3
2,2,1,2,2,4,4,2,4,3,4,2,4,2,4,4,4,1,1,1,1,2,2,2,2,1,1,1,1,1,1,1,1,1,1,1,2,4,1,3,3,3,3,3,4,4,3,3,3,1,3,2,4,1,3,4,2,4,2,4

